8
11100110
11010010
10011010
11101100
01000111
00110001
11011000
11000111
